R 1000 1000
NO ./xpm/tile_to_north.xpm
SO ./xpm/tile_to_south.xpm
WE ./xpm/tile_to_west.xpm
EA ./xpm/tile_to_east.xpm
S ./xpm/08_green_tree.xpm
F 220,100,0
C 225,30,0
11111111111111111
10002000000020001
10100021000000001
1W010010002002001
10100001000000001
10000000020000001
11111111111111111
