R 1000 1000
NO     ./xpm/tile_to_north.xpm
SO     ./xpm/tile_to_south.xpm
WE     ./xpm/tile_to_west.xpm
EA     ./xpm/tile_to_east.xpm
S      ./xpm/08_green_tree.xpm
F 220,100,0
C 0,0,0
        1111111111111111111111111
        1000000000110000000000001
        1011000001110000002000001
        1001000000000000000000001
111111111011000001110000000000001
100000000011000001110111111111111
11110111111111011100000010001
11110111111111011101010010001
11000000110101011100000000001
100020000E0000001100000010001
10000000000000001101010010001
1100000111010101111101111000111
11110111 1110101 101111010001
11111111 1111111 111111111111
