R 1000 1000
NO     ./xpm/tile_to_north.xpm
SO     ./xpm/tile_to_south.xpm
WE     ./xpm/tile_to_west.xpm
EA     ./xpm/tile_to_east.xpm
S      ./xpm/08_green_tree.xpm

F 0  , 0, 255
C 110, 30, 110

        1111111111111111111111111
        1000000000110000000000001
        1011000001110000002000001
        1001000000000000000000001
111111111011000001110000000000001
100000000011000001110111111111111
11110111111111011100000010001
11110111111111011100210010201
10000001101010111000100000201
10002000000000001100000010201
10000000000000001101010010001
11000001110101011111011110N0111
11110111 1110101 101111010001
11111111 1111111 111111111111
