111111111111111111111111111111
100000000000000001000000000001
100000000000000000000100010001
100000000000000001000100010001
100000000000000001000110110001
100000000000000001000000000001
100000000000000001110110110N01
100000000000000000000000010001
111111111111111111111111111111
